6 6
M29
T0
B13
R4-RT

B P O P B O
P O B M P M
G B G B P O
M R B G B O
G P P B P B
B G O B G B


