6 6
M21
T180
P6-Z8
R3-RT

R R B Z G B
R G O Z Z B
G P G G O G
R G O Z P B
B Z O Z B Z
R B Z G Z B


 